77777777777
72000700027
70100700007
70111010007
70010010107
77700010777
70010001007
70100010107
70101701007
72000710027
77777777777