66666666666
62000600026
60100600006
60111010006
60010010106
66600010666
60010001006
60100010106
60101601006
62000610026
66666666666