66666666666
62000700026
60100700006
60111010006
60010010106
67700010776
60010001006
60100010106
60101701006
62000710026
66666666666